主角队
	ソルテ	索鲁特
	セレン	塞莲
	フィロ	菲洛
	ブラック	布莱克
	
称号
	幸運のソルテ	幸运的索鲁特
	小さなセレン	小小的塞莲
	死にたがりのフィロ	想死的菲洛
	物知りのブラック	博学的布莱克

姓氏
	シュガル	修格尔
	クレイダル	库雷达路
	
配角
	レゼル村長	雷佐鲁村长
	サリエラ	萨利艾拉
	ルイン	雷恩
	剣聖アズモダイ	剑圣阿斯蒙蒂斯
	ドワイト	多怀特
	ルテア	露提亚
		ルテアさん	露提亚姐（布莱克称呼）

地名
	カリア	卡利亚

动物
	魔鳥ソラウオ	魔鸟空鱼
	デタラメ洞窟	德特拉美洞穴

魔法
	歪曲现实场	现实扭曲力场
	
职业
	サルベイジャー	回收者

货币
	マル	元

装备
	アタナイト	不死军
	
道具
	ボーラ	飞石索
	妖精合体	妖精合体
	魔法相转移	魔法相对转移
	魔女化	魔女化

暗号
	ルインのジャムを食べたのは私
	吃了雷恩的果酱的人是我
	
错误发音
	トードリ	杭樟

决定台词
	私が全てを手に入れた日
	我得到一切的那一天
